account_id,txid,time,type,is_transaction,amount,balance_before,balance_after
1000173742,100017374220-08-20236358,2023-08-20 13:36:54.285419,deposit,True,500,0,500
1000173742,100017374220-08-20233072,2023-08-20 13:36:57.352933,deposit,True,10,500,510
1000173742,100017374220-08-20238452,2023-08-20 13:37:03.842192,withdraw,True,15,510,495
1000173742,100017374220-08-20236249,2023-08-20 13:37:08.853107,withdraw,True,35,495,460
1000173742,100017374220-08-20237473,2023-08-20 13:37:11.550345,withdraw,True,10,460,450
1000173742,100017374220-08-20235647,2023-08-20 13:37:23.169675,deposit,True,350,450,800
