txid,time,type,is_transaction,amount,balance_before,balance_after
445818467512-08-20234054,2023-08-12 22:50:32.145505,deposit,True,100,0,100
445818467512-08-20239679,2023-08-12 22:50:35.284162,deposit,True,50,100,150
445818467512-08-20236356,2023-08-12 22:50:40.831962,withdraw,True,3,150,147
445818467512-08-20231901,2023-08-12 22:51:04.421015,deposit,True,5000,147,5147
445818467512-08-20232904,2023-08-12 22:51:09.980460,withdraw,True,35,5147,5112
445818467512-08-20238121,2023-08-12 22:53:22.513157,withdraw,True,35,5112,5077
