account_id,txid,time,type,is_transaction,amount,balance_before,balance_after
5831163628,583116362820-08-20231467,2023-08-20 13:36:37.641549,deposit,True,500,0,500
5831163628,583116362820-08-20235407,2023-08-20 13:36:50.951795,deposit,True,500,500,1000
5831163628,583116362820-08-20233862,2023-08-20 13:37:00.421178,deposit,True,34,1000,1034
5831163628,583116362820-08-20232482,2023-08-20 13:37:14.721601,deposit,True,1000,1034,2034
5831163628,583116362820-08-20238309,2023-08-20 13:37:17.938408,deposit,True,500,2034,2534
5831163628,583116362820-08-20235003,2023-08-20 13:37:25.984139,deposit,True,250,2534,2784
